14
12 15 14 12 15 14 14 14 12 15 14 12 15 14
14
14 14 14 15 14 12 15 14 14 14 15 14 12 15
14
14 14 12 15 14 12 15 14 14 14 12 15 14 12
14
15 14 14 14 12 15 14 12 15 14 14 14 12 15
6
14 12 15 14 14 14
###
14
4 2 3 3 1 3 1 3 4 2 3 3 1 3
14
1 3 4 2 3 3 1 1 3 4 2 3 3 1
14
1 3 3 2 3 3 1 3 1 3 3 2 3 3
14
1 3 1 3 4 2 3 3 1 3 1 3 4 2
6
3 3 1 3 1 3
###
